<oov>	<oov>
<sil>	SIL
mɔngɔɮʧ͡ʰʊːt	 m ɔ n g ɔ ɮ ʧ͡ʰ ʊː t
peɮgeteɮ	 p e ɮ g e t e ɮ
jos	 j o s
ʊɮamʧ͡ɮaɮiːn	 ʊ ɮ a m ʧ͡ ɮ a ɮ iː n
tʰɔm	 tʰ ɔ m
sɔjoɮtʰɔj	 s ɔ j o ɮ tʰ ɔ j
tʰumen	 tʰ u m e n
tʰœrijnxœœ	 tʰ œ r i j n x œ œ
suɮtijg	 s u ɮ t i j g
mantaɮ	 m a n t a ɮ
patraɮiːn	 p a t r a ɮ iː n
pɔɮgɔʧ͡	 p ɔ ɮ g ɔ ʧ͡
ʧ͡ʰɔnɔn	 ʧ͡ʰ ɔ n ɔ n
suɮteːr	 s u ɮ t eː r
aʦ͡	 a ʦ͡
xijmɔrijg	 x i j m ɔ r i j g
tʰœɮœœɮuːteg	 tʰ œ ɮ œ œ ɮ uː t e g
teːɮeːr	 t eː ɮ eː r
tewʧ͡ix	 t e w ʧ͡ i x
xœgʧ͡ixijg	 x œ g ʧ͡ i x i j g
suːɮeːr	 s uː ɮ eː r
xɔjrgɔʃiʧ͡	 x ɔ j r g ɔ ʃ i ʧ͡
ʦ͡aɮxʊːraxiːg	 ʦ͡ a ɮ x ʊː r a x iː g
ʦ͡ʊraɮtʰ	 ʦ͡ ʊ r a ɮ tʰ
pɔɮɔn	 p ɔ ɮ ɔ n
pijreːr	 p i j r eː r
piʧ͡ʰix	 p i ʧ͡ʰ i x
tʰʊːrwixiːg	 tʰ ʊː r w i x iː g
ʃiɮeːr	 ʃ i ɮ eː r
ʦ͡ewer	 ʦ͡ e w e r
tʰʊngaɮagijg	 tʰ ʊ n g a ɮ a g i j g
teɮeːr	 t e ɮ eː r
erx	 e r x
ʧ͡ʰœɮœœg	 ʧ͡ʰ œ ɮ œ œ g
taɮaːr	 t a ɮ aː r
teːtɮeɮ	 t eː t ɮ e ɮ
xuntɮeɮijg	 x u n t ɮ e ɮ i j g
tʰʊs	 tʰ ʊ s
peɮgetteg	 p e ɮ g e t t e g
mœn	 m œ n
xɔːɮɮɔx	 x ɔː ɮ ɮ ɔ x
xʊwʦ͡asɮaxtaː	 x ʊ w ʦ͡ a s ɮ a x t aː
ʧ͡ʰ	 ʧ͡ʰ
tʰɔgtʰsɔn	 tʰ ɔ g tʰ s ɔ n
jostʰɔj	 j o s tʰ ɔ j
pœgœœt	 p œ g œ œ t
taɮiːg	 t a ɮ iː g
ʦ͡ʊɮgaːʧ͡	 ʦ͡ ʊ ɮ g aː ʧ͡
itexijg	 i t e x i j g
ʦ͡eːrɮeʧ͡	 ʦ͡ eː r ɮ e ʧ͡
taɮʊːɮ	 t a ɮ ʊː ɮ
pajsan	 p a j s a n
xʊwaːʧ͡	 x ʊ w aː ʧ͡
amstag	 a m s t a g
pɔɮ	 p ɔ ɮ
er	 e r
xun	 x u n
teːɮijg	 t eː ɮ i j g
xujsneːs	 x u j s n eː s
teːguːr	 t eː g uː r
pusɮexijg	 p u s ɮ e x i j g
tɔːgʊːr	 t ɔː g ʊː r
pusɮeteg	 p u s ɮ e t e g
ʃiɮijg	 ʃ i ɮ i j g
narant	 n a r a n t
gjaɮpʊːɮax	 g j a ɮ p ʊː ɮ a x
atʊːniː	 a t ʊː n iː
teɮijg	 t e ɮ i j g
emeːɮijn	 e m eː ɮ i j n
purteɮ	 p u r t e ɮ
xesgijg	 x e s g i j g
xɔg	 x ɔ g
teːr	 t eː r
xajax	 x a j a x
ajragniː	 a j r a g n iː
puɮuːr	 p u ɮ uː r
tʰœmrœœr	 tʰ œ m r œ œ r
xijx	 x i j x
xuːxet	 x uː x e t
tuːguːr	 t uː g uː r
xijʧ͡	 x i j ʧ͡
tʰɔgɮɔx	 tʰ ɔ g ɮ ɔ x
pijrijg	 p i j r i j g
gaʦ͡ar	 g a ʦ͡ a r
ʦ͡ergijg	 ʦ͡ e r g i j g
ʦ͡eːrɮeteg	 ʦ͡ eː r ɮ e t e g
ene	 e n e
nʲ	 nʲ
ʊɮamʧ͡ɮaɮ	 ʊ ɮ a m ʧ͡ ɮ a ɮ
axʊj	 a x ʊ j
sɔjoɮɔː	 s ɔ j o ɮ ɔː
xamgaːɮax	 x a m g aː ɮ a x
untesnij	 u n t e s n i j
tarxɮaː	 t a r x ɮ aː
pɔɮtɔg	 p ɔ ɮ t ɔ g
ʦ͡ʊrgʊːɮ	 ʦ͡ ʊ r g ʊː ɮ
ɮaːniː	 ɮ aː n iː
tœɮijg	 t œ ɮ i j g
ʃirtʰen	 ʃ i r tʰ e n
pɔtɮɔgʃirɔngʊj	 p ɔ t ɮ ɔ g ʃ i r ɔ n g ʊ j
sʊːna	 s ʊː n a
tʰerxen	 tʰ e r x e n
ʦ͡ʊːriːg	 ʦ͡ ʊː r iː g
ugeːr	 u g eː r
xeɮexijn	 x e ɮ e x i j n
argaguj	 a r g a g u j
nam	 n a m
gum	 g u m
eʦ͡emtew	 e ʦ͡ e m t e w
getʰeɮ	 g e tʰ e ɮ
sœɮœr	 s œ ɮ œ r
gɔʧ͡ʰɔː	 g ɔ ʧ͡ʰ ɔː
ʧ͡ʰimeːgujg	 ʧ͡ʰ i m eː g u j g
ewten	 e w t e n
gereɮt	 g e r e ɮ t
tʰemuːɮen	 tʰ e m uː ɮ e n
gaɮt	 g a ɮ t
ʃatʰaʧ͡	 ʃ a tʰ a ʧ͡
pʊj	 p ʊ j
erweːxijn	 e r w eː x i j n
surgijn	 s u r g i j n
tʰʊxaj	 tʰ ʊ x a j
ijm	 i j m
tuːɮger	 t uː ɮ g e r
xuneːs	 x u n eː s
garamguj	 g a r a m g u j
jaria	 j a r i a
teɮgew	 t e ɮ g e w
ʧ͡ʰœtʰgœr	 ʧ͡ʰ œ tʰ g œ r
pɔɮɔr	 p ɔ ɮ ɔ r
taɮawʧ͡ʰtʰaj	 t a ɮ a w ʧ͡ʰ tʰ a j
pɔɮgɔnɔ	 p ɔ ɮ g ɔ n ɔ
xemeːn	 x e m eː n
erweːxijg	 e r w eː x i j g
pɔːɮɔːr	 p ɔː ɮ ɔː r
awʧ͡ʰeː	 a w ʧ͡ʰ eː
tʰamxi	 tʰ a m x i
asaːx	 a s aː x
gaɮ	 g a ɮ
ɔɮʧ͡	 ɔ ɮ ʧ͡
irweɮ	 i r w e ɮ
xuseɮ	 x u s e ɮ
ʧ͡ʰinʲ	 ʧ͡ʰ i nʲ
pieɮene	 p i e ɮ e n e
geʧ͡	 g e ʧ͡
pieɮex	 p i e ɮ e x
xusɮijn	 x u s ɮ i j n
tʊːɮaɮ	 t ʊː ɮ a ɮ
ʦ͡urxenteː	 ʦ͡ u r x e n t eː
egʃigɮuːɮsen	 e g ʃ i g ɮ uː ɮ s e n
erweːxij	 e r w eː x i j
pɔːɮiːg	 p ɔː ɮ iː g
ɮaː	 ɮ aː
ʊɮpar	 ʊ ɮ p a r
tœɮœœr	 t œ ɮ œ œ r
taɮɮaʧ͡	 t a ɮ ɮ a ʧ͡
nataːs	 n a t aː s
aw	 a w
xemeːʧ͡	 x e m eː ʧ͡
tʰegeːt	 tʰ e g eː t
naɮ	 n a ɮ
xɔjor	 x ɔ j o r
xœœrxij	 x œ œ r x i j
erweːxejn	 e r w eː x e j n
amʲ	 a mʲ
pieijg	 p i e i j g
xʊwaːn	 x ʊ w aː n
ʦ͡aɮgitag	 ʦ͡ a ɮ g i t a g
pɔɮʧ͡	 p ɔ ɮ ʧ͡
piɮpuːr	 p i ɮ p uː r
ɔrʧ͡ʰɮɔngijn	 ɔ r ʧ͡ʰ ɮ ɔ n g i j n
saːraɮ	 s aː r a ɮ
œngœ	 œ n g œ
pʊjuʊ	 p ʊ j u ʊ
geːt	 g eː t
sʊɮaːr	 s ʊ ɮ aː r
sanaː	 s a n aː
aɮtɮaː	 a ɮ t ɮ aː
ʦ͡ʊniː	 ʦ͡ ʊ n iː
teɮger	 t e ɮ g e r
ʦ͡agtʰ	 ʦ͡ a g tʰ
jatargaː	 j a t a r g aː
tʰajɮax	 tʰ a j ɮ a x
xɔːɮniː	 x ɔː ɮ n iː
ʧ͡ɔr	 ʧ͡ ɔ r
tʰaniɮʦ͡ʊːɮʧ͡	 tʰ a n i ɮ ʦ͡ ʊː ɮ ʧ͡
pajna	 p a j n a
xɔniniː	 x ɔ n i n iː
pœœrœœr	 p œ œ r œ œ r
xʊːʃʊːr	 x ʊː ʃ ʊː r
xijxteː	 x i j x t eː
tœrwuːɮ	 t œ r w uː ɮ
jumʊː	 j u m ʊː
tɔɮʊːɮ	 t ɔ ɮ ʊː ɮ
itexeːr	 i t e x eː r
kg	 k g
pœœr	 p œ œ r
ɔrnɔ	 ɔ r n ɔ
ɔtɔː	 ɔ t ɔː
ɔɮɔn	 ɔ ɮ ɔ n
xunsnij	 x u n s n i j
teɮguːr	 t e ɮ g uː r
ʦ͡artag	 ʦ͡ a r t a g
pɔɮsɔn	 p ɔ ɮ s ɔ n
pœœrijg	 p œ œ r i j g
ʧ͡iʧ͡igɮen	 ʧ͡ i ʧ͡ i g ɮ e n
xerʧ͡ʰiʧ͡	 x e r ʧ͡ʰ i ʧ͡
sɔnginɔ	 s ɔ n g i n ɔ
tawsaːr	 t a w s aː r
amtʰɮana	 a m tʰ ɮ a n a
tawsniː	 t a w s n iː
ʧ͡ʰanga	 ʧ͡ʰ a n g a
sʊɮiːg	 s ʊ ɮ iː g
œœrijnxœœrœœ	 œ œ r i j n x œ œ r œ œ
tʰɔxirʊːɮna	 tʰ ɔ x i r ʊː ɮ n a
suːɮijg	 s uː ɮ i j g
xijweɮ	 x i j w e ɮ
amtʰtʰaj	 a m tʰ tʰ a j
taraː	 t a r aː
gʊriɮaː	 g ʊ r i ɮ aː
ʦ͡ʊːrʊːɮ	 ʦ͡ ʊː r ʊː ɮ
ʦ͡ʊːrsan	 ʦ͡ ʊː r s a n
nʊxaʧ͡	 n ʊ x a ʧ͡
ʦ͡œœɮruːɮ	 ʦ͡ œ œ ɮ r uː ɮ
ʧ͡ʰimxeʧ͡	 ʧ͡ʰ i m x e ʧ͡
ʃaraːt	 ʃ a r aː t
xaɮʊːnaːr	 x a ɮ ʊː n aː r
iteːrej	 i t eː r e j
pɔːtɔɮ	 p ɔː t ɔ ɮ
emneːs	 e m n eː s
iɮuː	 i ɮ uː
tʰaniː	 tʰ a n iː
ʧ͡ʰiɮger	 ʧ͡ʰ i ɮ g e r
tʰamirʧ͡ʊːɮna	 tʰ a m i r ʧ͡ ʊː ɮ n a
eːne	 eː n e
ʧ͡ɔriːg	 ʧ͡ ɔ r iː g
najʦ͡taː	 n a j ʦ͡ t aː
piʧ͡ʰuːɮ	 p i ʧ͡ʰ uː ɮ
ɔɮɔnt	 ɔ ɮ ɔ n t
ʦ͡arɮa	 ʦ͡ a r ɮ a