<oov>	<oov>
<sil>	SIL
pi	 p i
ʧ͡ʰiɮger	 ʧ͡ʰ i ɮ g e r
gesen	 g e s e n
ʦ͡ʊːraːr	 ʦ͡ ʊː r aː r
teɮijg	 t e ɮ i j g
ʦ͡aːrʊːɮ	 ʦ͡ aː r ʊː ɮ
teɮguːr	 t e ɮ g uː r
xɔjor	 x ɔ j o r
teɮger	 t e ɮ g e r
suɮijg	 s u ɮ i j g
taɮiːg	 t a ɮ iː g
teɮeːr	 t e ɮ eː r
taɮaːr	 t a ɮ aː r
aʧ͡iɮ	 a ʧ͡ i ɮ
tɔɮiːg	 t ɔ ɮ iː g
sʊɮaːr	 s ʊ ɮ aː r
teːɮeːr	 t eː ɮ eː r
pɔːtɔɮ	 p ɔː t ɔ ɮ
atiɮ	 a t i ɮ
ʦ͡eːɮper	 ʦ͡ eː ɮ p e r
tuːguːr	 t uː g uː r
ʃiɮijg	 ʃ i ɮ i j g
minij	 m i n i j
ʦ͡arɮa	 ʦ͡ a r ɮ a
suɮteːr	 s u ɮ t eː r
suːɮijg	 s uː ɮ i j g
pʰaɮ	 pʰ a ɮ
taɮʊːɮ	 t a ɮ ʊː ɮ
ʃiɮeːr	 ʃ i ɮ eː r
tɔːgʊːr	 t ɔː g ʊː r
sœɮœr	 s œ ɮ œ r
ʦ͡ʊːriːg	 ʦ͡ ʊː r iː g
ʧ͡ʰat	 ʧ͡ʰ a t
pʊɮʊːr	 p ʊ ɮ ʊː r
ʦ͡ʊraɮtʰ	 ʦ͡ ʊ r a ɮ tʰ
ʦ͡ʊːrʊːɮ	 ʦ͡ ʊː r ʊː ɮ
tʊːɮaɮ	 t ʊː ɮ a ɮ
pɔːɮɔːr	 p ɔː ɮ ɔː r
ʦ͡am	 ʦ͡ a m
purteɮ	 p u r t e ɮ
sʊɮiːg	 s ʊ ɮ iː g
tœɮœœr	 t œ ɮ œ œ r
tuːɮger	 t uː ɮ g e r
ʦ͡ʊrgʊːɮ	 ʦ͡ ʊ r g ʊː ɮ
xaɮ	 x a ɮ
tijɮeɮtʰ	 t i j ɮ e ɮ tʰ
tœɮijg	 t œ ɮ i j g
tɔɮʊːɮ	 t ɔ ɮ ʊː ɮ
tœrwuːɮ	 t œ r w uː ɮ
ɮam	 ɮ a m
pœœrœœr	 p œ œ r œ œ r
ʦ͡œœɮrœɮtʰ	 ʦ͡ œ œ ɮ r œ ɮ tʰ
piɮpuːr	 p i ɮ p uː r
paːɮiːg	 p aː ɮ iː g
tɔɮɔːr	 t ɔ ɮ ɔː r
waːr	 w aː r
pijrijg	 p i j r i j g
tijɮuːɮ	 t i j ɮ uː ɮ
teːɮijg	 t eː ɮ i j g
pijreːr	 p i j r eː r
paːɮaːr	 p aː ɮ aː r
saːraɮ	 s aː r a ɮ
suːɮeːr	 s uː ɮ eː r
teːguːr	 t eː g uː r
pɔːɮiːg	 p ɔː ɮ iː g
pɔɮɔr	 p ɔ ɮ ɔ r
pœrijg	 p œ r i j g
ʦ͡œœɮruːɮ	 ʦ͡ œ œ ɮ r uː ɮ
